--------------------
     ####
        ###
     ##
             -#-
     ----


PGPPGGPPGGGPGPGGGPGG
PGGGGPGGGPGGGPGPGGPG
PGPPGPGGGPPPGGGPGGGP
SSSSSSSSSSSSSSSSSSSS
 B   T    B    T   T
M      D  M   D
Y      V    Y
 D    M   D      M
SSSSSSSSSSSSSSSSSSSS
GGGGGGGGGGGGGGGGGGGG
GGGGGGGGGGGGGGGGGGGG
GGGGGGGGGGGGGGGGGGGG