--------------------
GGGGGGGGGGGGGGGGGGGG
GGGGGGGGGGGGGGGGGGGG
  B     B       T
M      D       M
Y      V    Y
GGGGGGGGGGGGGGGGGGGG
GGGGGGGGGGGGGGGGGGGG
W J J  J J       J J
  O    O    O    O--
J J       J J  J J--
O    O    O    O   W
SSSSSSSSSSSSSSSSSSSS
    R
                   E
R
SSSSSSSSSSSSSSSSSSSS
GGGGGGGGGGGGGGGGGGGG
GGGGGGGGGGGGGGGGGGGG
GGGGGGGGGGGGGGGGGGGG