--------------------
GGGGGGGGGGGGGGGGGGGG
GGGGGGGGGGGGGGGGGGGG
                   E
W K K  K K  K K  K K
  L    L    L    L--
K K  K K  K K  K K--
L    L    L    L   W
PGPPGPGGGPPPGGGPGGGP
GGGPGGGGPPGGGGGPGPGG
p       rr      rr--
     rrrrrrr  rrrrrr
 r   r    r      r--
 rrrrr   rrrr   rrrr
rr       r  r    r--
 r   rrrrr  rrrrrr--
rr     r       r   p
GPGPGGGPGGGPGPGGPPGG
GGPPGGGGGGGGPPGGGPGG
GPGGPPGGGGPGGPPGGGGG