--------------------
GGGGGGGGGGGGGGGGGGGG
R
GGGGGGGGGGGGGGGGGGGG
W J J  J J  J J  J J
 O    O    O    O
K K  K K  K K  K K
 L    L    L    L  F
PGPPGGPPGGGPGPGGGPGG
PGGGGPGGGPGGGPGPGGPG
PGPPGPGGGPPPGGGPGGGP
SSSSSSSSSSSSSSSSSSSS
 B   T    B    T   T
M      D  M   D
Y      V    Y
 D    M   D      M
SSSSSSSSSSSSSSSSSSSS
GGGGGGGGGGGGGGGGGGGG
GGGGGGGGGGGGGGGGGGGG
GGGGGGGGGGGGGGGGGGGG