--------------------
GGGGGGGGGGGGGGGGGGGG
R
GGGGGGGGGGGGGGGGGGGG
W K K  K K  K K  K K
  L    L    L    L--
K K  K K  K K  K K--
L    L    L    L  FW
PGPPGGPPGGGPGPGGGPGG
PGGGGPGGGPGGGPGPGGPG
PGPPGPGGGPPPGGGPGGGP
SSSSSSSSSSSSSSSSSSSS
 B   T    B    T   T
M      D  M   D
Y      V    Y
 D    M   D      M
SSSSSSSSSSSSSSSSSSSS
GGGGGGGGGGGGGGGGGGGG
GGGGGGGGGGGGGGGGGGGG
GGGGGGGGGGGGGGGGGGGG