--------------------
GGGGGGGGGGGGGGGGGGGG
GGGGGGGGGGGGGGGGGGGG
  B     B       T
Y      V    Y
   D      M       M
GGGPGGGGPPGGGGGPGPGG
PGPPGGPPGGGPGPGGGPGG
PGPPGPGGGPPPGGGPGGGP
p   rrr-------------
     rrrrrrrrrrrrrr-
                 r--
        rrrrr    r--
   r    r   r    r--
   r    r   rrrrrr--
 rrrrrrrr-----------
rr                 p
GGGGGGGGGGGGGGGGGGGG
GGGGGGGGGGGGGGGGGGGG
GGGGGGGGGGGGGGGGGGGG