--------------------
GGGGGGGGGGGGGGGGGGGG
GGGGGGGGGGGGGGGGGGGG
p        rrrr-------
            rrrrrr--
 r       r       r--
 rrrrr   rrrr   rrrr
rr   r   r  r    r--
 r   rrrrr--rrrrrr--
rr                 p
PGPPGGPPGGGPGPGGGPGG
SSSSSSSSSSSSSSSSSSSS
 N     H      N
  V        V     Y
 D      D      M
T      B    T
SSSSSSSSSSSSSSSSSSSS
GPGPGGGPGGGPGPGGPPGG
GGPPGGGGGGGGPPGGGPGG
GPGGPPGGGGPGGPPGGGGG