--------------------
GGGGGGGGGGGGGGGGGGGG
GGGGGGGGGGGGGGGGGGGG
p        rrrr-------
            rrrrrr--
 r       r       r--
 rrrrr   rrrr   rrrr
rr   r   r  r    r--
 r   rrrrr--rrrrrr--
rr                 a
PGPPGGPPGGGPGPGGGPGG
SSSSSSSSSSSSSSSSSSSS
 B   T    B    T   T
M      D  M   D
Y      V    Y
 D    M   D      M
SSSSSSSSSSSSSSSSSSSS
GGGGGGGGGGGGGGGGGGGG
GGGGGGGGGGGGGGGGGGGG
GGGGGGGGGGGGGGGGGGGG