--------------------
W


   J    J    J    J
   K    K    K    K
   O    O    O    O
L    L    L    L   F
PGPPGGPPGGGPGPGGGPGG
PGGGGPGGGPGGGPGPGGPG
PGPPGPGGGPPPGGGPGGGP
SSSSSSSSSSSSSSSSSSSS
 B   T    B    T   T
M      D  M   D
Y      V    Y
 D    M   D      M
SSSSSSSSSSSSSSSSSSSS
GGGGGGGGGGGGGGGGGGGG
GGGGGGGGGGGGGGGGGGGG
GGGGGGGGGGGGGGGGGGGG