--------------------
GGGGGGGGGGGGGGGGGGGG
GGGGGGGGGGGGGGGGGGGG
p-------------------
--------------------
-r    r    r    r---
--------------------
c c  c c  c c  c c--
    c c  c c  c c---
 r    r    r    r ap
PGPPGGPPGGGPGPGGGPGG
SSSSSSSSSSSSSSSSSSSS
 B   T    B    T   T
M      D  M   D
Y      V    Y
 D    M   D      M
SSSSSSSSSSSSSSSSSSSS
GGGGGGGGGGGGGGGGGGGG
GGGGGGGGGGGGGGGGGGGG
GGGGGGGGGGGGGGGGGGGG